#####################
#...................#
#O###.#### ####.###O#
#...................#
###.# ######### #.###
###.#     M     #.###
###.# #### #### #.###
#  .  # M M M #  .  #
###.# ######### #.###
###.#           #.###
###.# ######### #.###
#.........C.........#
#O###.#### ####.###O#
#...................#
#####################