#####################
#F     B  #        F#
# ## #### # #### ## #
#  # #    F    # #  #
## # # ### ### # # ##
#  # #         # #  #
##     #######     ##
#  ###    C    ###  #
# ##   # ### #   ## #
#    ###     ###    #
# ##     ###     ## #
# #  # #     #B#  # #
# # ## ### ### ## # #
#    #    F    #    #
# ##   #  #  #   ## #
# ### ### # ### ### #
#F                 F#
#####################