XXXXXXXXXXXXXXXXXXXXXXXXXXXXXXXXXXXXXXXXX
XX   XXXXXXXXXXXXXXXXXXXXXXXXXXXXXXXXXXXX
XX Z               XXXXXXXXXXXXXX  Z  XXX
XX   XXXXXXXXXXXXX                    o X
XXX XXXXXXXXXXXXXXXXXXX XXXXXXXXXXXX XXXX
X       XXXXXXXXXXXXXXX XXXXXXXXXXXX XXXX
X       XXXXXXXXXXXX Z    XXXXXXXXXX XXXX
XXXXX XXXXXXXXXXXXXX                 XXXX
XXXXX XXXXX     XXXX XXXXXXXXXX  Z   XXXX
|            Z       XXXXXXXXXXXXXXXXXXXX
XXXXXXXXXXXXXXXXXXXXXXXXXXXXXXXXXXXXXXXXX